#######E#############################
# ### #   ###### #    #     #     # #
# ### ### #      #  #    #     #    #
# ### # # # ###### ##################
#            #       #    #   #   # #
#  # ##      # ##### #  # # # # # # #
#  #         #   #   #  # # # # #   #
#  ######   ###  #  ### # # # # ### #
#  #    #               #   #   #   #
#  # ## ########   ## ###########   #
#    ##          ###                #
#### #############  ###   ####   ## #
#  ### ##         #  #  #           #
#  #   ## ####     #    #      ###  #
#  # #### #  #     #    #####       #
#  #      #      ###           ##   #
#  #####           #   ##   #   #   #
#                 ^                 #
#####################################
