#######################################
#        # ###      ##    ###  #      #
#  ### # #     ### #### #  ##  # ###  #
#    # # # ##### #       #  ## # # #  #
#  ### #   ##    #######  # #  # # #  #
#    # # # #  ## #      # # #    # #  #
#  ### # # # #   # #### # # # ## # #  #
#    # # # # # ###    # # # #         #
#  # # # ### # # #### # # #   #########
#    # #   # # #   ^  # # # # #       #
#  # # ## ## # ## ##### # # #   ##### #
#    #     # #    #   # # # #####     #
#  #########  ##### # ##  #       #####
#          ##       #    ## ####### # E
########## ################ #       # #
#          #            #     ####### #
#  ######### ###### # # # #####       #
#    #   #   #      # # ### # # #######
#  #   #   # # #### # #               #
#  #   #   # # #### # #               #
#######################################
